Clue
An Interactive Fiction by the Andersons
Release 1 / Serial number 231122 / Inform 7 v10.1.2 / D

Entryway
Welcome to Clue! Your name is Detective Black. You are investigating a murder in the Mystery Mansion. You can move around the mansion, find suspects, the murder weapon (as well as some red herrings), and the scene of the crime. Once you've deduced the murder weapon, murderer, and room where the murder took place, you win! Just don't run out of time...

If you need help, type "help".

The hall is to your south.

>SCOPE
1: yourself (594680)

>s
Hall
The study is to your northwest, the lounge is to your northeast, the ballroom is to your south, the library is to your southwest, and the dining room is to your southeast.

>SCOPE
1: yourself (594680)

>e
Lounge
The hall is to your west, and the dining room is to your south.

You can see a small pistol here.

>SCOPE
1: yourself (594680)
2: a small pistol (595320)

>LIST
That's not a verb I recognise.

>list objevts
That's not a verb I recognise.

>list objects
That's not a verb I recognise.

>LIST OBJECTS
That's not a verb I recognise.

* * *

Clue
An Interactive Fiction by the Andersons
Release 1 / Serial number 231122 / Inform 7 v10.1.2 / D

Entryway
Welcome to Clue! Your name is Detective Black. You are investigating a murder in the Mystery Mansion. You can move around the mansion, find suspects, the murder weapon (as well as some red herrings), and the scene of the crime. Once you've deduced the murder weapon, murderer, and room where the murder took place, you win! Just don't run out of time...

If you need help, type "help".

The hall is to your south.

>SHOWME hall
Hall - room
    thin rope - rope
singular-named, proper-named; lighted, unvisited, murder room
list grouping key: none
printed name: "Hall"
printed plural name: none
indefinite article: none
description: "The study is to your northwest, the lounge is to your northeast, the ballroom is to your south, the library is to your southwest, and the dining room is to your southeast."

>showme entryway
Entryway - room
    yourself - person
singular-named, proper-named; lighted, visited
list grouping key: none
printed name: "Entryway"
printed plural name: none
indefinite article: none
description: "The hall is to your south."

>s
Hall
The study is to your northwest, the lounge is to your northeast, the ballroom is to your south, the library is to your southwest, and the dining room is to your southeast.

You can see a thin rope here.

>l at rope
The thin rope is covered in blood!

>SHOWME rope
thin rope - rope
location: in Hall
singular-named, improper-named; unlit, inedible, portable
list grouping key: none
printed name: "thin rope"
printed plural name: "ropes"
indefinite article: none
description: none
initial appearance: none

>e
Lounge
The hall is to your west, and the dining room is to your south.

You can see a pocketknife, a dull silver candlestick and Professor Plum here.

>l at knife
You can't see any such thing.

>l at
What do you want to look at?

>l at pocketknife
You see nothing special about the pocketknife.

>RULES
Rules tracing now switched on. Type "rules off" to switch it off again, or "rules all" to include even rules which do not apply.

* * *

Clue
An Interactive Fiction by the Andersons
Release 1 / Serial number 231122 / Inform 7 v10.1.2 / D

Entryway
Welcome to Clue! Your name is Detective Black. You are investigating a murder in the Mystery Mansion. You can move around the mansion, find suspects, the murder weapon (as well as some red herrings), and the scene of the crime. Once you've deduced the murder weapon, murderer, and room where the murder took place, you win! Just don't run out of time...

If you need help, type "help".

The hall is to your south.

>accuse
   Colonel Mustard
 > Make an accusation

>accuse
 > Introduction to Clue
   About the Author
   About the Author
 > Introduction to Clue
   About the Author
   About the Author

* * *

>accuse
   Colonel Mustard
 > Make an accusation

>menu
That's not a verb I recognise.

* * *

Clue
An Interactive Fiction by the Andersons
Release 1 / Serial number 231122 / Inform 7 v10.1.2 / D

Entryway
Welcome to Clue! Your name is Detective Black. You are investigating a murder in the Mystery Mansion. You can move around the mansion, find suspects, the murder weapon (as well as some red herrings), and the scene of the crime. Once you've deduced the murder weapon, murderer, and room where the murder took place, you win! Just don't run out of time...

If you need help, type "help".

The hall is to your south.

>go to entryway
That noun did not make sense in this context.

>go to hall
You walk to Hall.

Hall
The study is to your northwest, the lounge is to your northeast, the ballroom is to your south, the library is to your southwest, and the dining room is to your southeast.

>go to hall
That noun did not make sense in this context.

* * *

Clue
An Interactive Fiction by the Andersons
Release 1 / Serial number 231122 / Inform 7 v10.1.2 / D

Entryway
Welcome to Clue! Your name is Detective Black. You are investigating a murder in the Mystery Mansion. You can move around the mansion, find suspects, the murder weapon (as well as some red herrings), and the scene of the crime. Once you've deduced the murder weapon, murderer, and room where the murder took place, you win! Just don't run out of time...

If you need help, type "help".

The hall is to your south.

>go to hall
You walk to Hall.

Hall
The study is to your northwest, the lounge is to your northeast, the ballroom is to your south, the library is to your southwest, and the dining room is to your southeast.

>go to Hall
You can't see any such thing.

>s
Hall
The study is to your northwest, the lounge is to your northeast, the ballroom is to your south, the library is to your southwest, and the dining room is to your southeast.

>go to Study
You can't see any such thing.

>go to study
You can't see any such thing.

>w
Study
The hall is to your east, and the library is to your south.

>e
Hall
The study is to your northwest, the lounge is to your northeast, the ballroom is to your south, the library is to your southwest, and the dining room is to your southeast.

>go to study
You can't see any such thing.

>go to Study
You can't see any such thing.

* * *

>s
Hall
The study is to your northwest, the lounge is to your northeast, the ballroom is to your south, the library is to your southwest, and the dining room is to your southeast.

>s
Ballroom
The billiard room is to the northwest, the hall is to the north, the dining room is to the northeast, the conservatory is to the southwest, and the kitchen is to the southeast.

>go to hall
You can't see any such thing.

>go to Hall
You can't see any such thing.

>Hall
That's not a verb I recognise.

>hall
That's not a verb I recognise.

* * *

>go to hall
You walk to Hall.

Hall
The study is to your northwest, the lounge is to your northeast, the ballroom is to your south, the library is to your southwest, and the dining room is to your southeast.

>go to study
You walk to Study.

Study
The hall is to your east, and the library is to your south.

>go to hall
You walk to Hall.

Hall
The study is to your northwest, the lounge is to your northeast, the ballroom is to your south, the library is to your southwest, and the dining room is to your southeast.

* * *

>go to hall
That noun did not make sense in this context.

>go to Study
You walk to Study.

Study
The hall is to your east, and the library is to your south.

>go to library
You walk to Library.

Library
The study is to your north, the hall is to your east, and the billiard room is to your south.

>go to billiard room
You walk to Billiard Room.

Billiard Room
The library is to the north, the ballroom is to the east, the conservatory is to thr south.

>go to billiard room
That noun did not make sense in this context.

* * *

>go to study
You walk to Study.

Study
The hall is to your east, and the library is to your south.

>go to kitchen
That noun did not make sense in this context.

>go to library
You walk to Library.

Library
The study is to your north, the hall is to your east, and the billiard room is to your south.

>go to the library
That noun did not make sense in this context.

* * *

Clue
An Interactive Fiction by the Andersons
Release 1 / Serial number 231122 / Inform 7 v10.1.2 / D

Entryway
Welcome to Clue! Your name is Detective Black. You are investigating a murder in the Mystery Mansion. You can move around the mansion, find suspects, the murder weapon (as well as some red herrings), and the scene of the crime. Once you've deduced the murder weapon, murderer, and room where the murder took place, you win! Just don't run out of time...

If you need help, type "help".

The hall is to your south.

>go to library
That noun did not make sense in this context.

>s
Hall
The study is to your northwest, the lounge is to your northeast, the ballroom is to your south, the library is to your southwest, and the dining room is to your southeast.

You can see a heavy gray handgun and Mr Green here.

>l at pistol
You can't see any such thing.

>l at candlestick
You can't see any such thing.

>l at plum
You can't see any such thing.

>l at mustard
You can't see any such thing.

>nw
Study
The hall is to your east, and the library is to your south.

You can see a bronze candlestick, Ms Peacock and Mrs White here.

>l at white
You see nothing special about Mrs White.

>ne
You can't go that way.

>s
Library
The study is to your north, the hall is to your east, and the billiard room is to your south.

You can see a lugwrench and a pocketknife here.

>l at lugwrench
You see nothing special about the lugwrench.

>s
Billiard Room
The library is to the north, the ballroom is to the east, the conservatory is to the south.

>l at scarlet
You can't see any such thing.

>l at candlestick
You can't see any such thing.

>l at billiard room
You can't see any such thing.

>l at room
You can't see any such thing.

>sd
That's not a verb I recognise.

>s
Conservatory
The ballroom is to the east. The billiard room is to the north.

>e
Ballroom
The billiard room is to the northwest, the hall is to the north, the dining room is to the northeast, the conservatory is to the southwest, and the kitchen is to the southeast.

You can see a thin rope here.

* * *

Clue
An Interactive Fiction by the Andersons
Release 1 / Serial number 231122 / Inform 7 v10.1.2 / D

Entryway
Welcome to Clue! Your name is Detective Black. You are investigating a murder in the Mystery Mansion. You can move around the mansion, find suspects, the murder weapon (as well as some red herrings), and the scene of the crime. Once you've deduced the murder weapon, murderer, and room where the murder took place, you win! Just don't run out of time...

If you need help, type "help".

The hall is to your south.

>go to the hall
You walk to Hall.

Hall
The study is to your northwest, the lounge is to your northeast, the ballroom is to your south, the library is to your southwest, and the dining room is to your southeast.

>go to entryway
You walk to Entryway.

Entryway
The hall is to your south.

>s
Hall
The study is to your northwest, the lounge is to your northeast, the ballroom is to your south, the library is to your southwest, and the dining room is to your southeast.

>n
Don't leave yet, detective! There is still a mystery to solve!

>go to entryway
You walk to Entryway.

Entryway
The hall is to your south.

* * *

Clue
An Interactive Fiction by the Andersons
Release 1 / Serial number 231122 / Inform 7 v10.1.2 / D

Entryway
Welcome to Clue! Your name is Detective Black. You are investigating a murder in the Mystery Mansion. You can move around the mansion, find suspects, the murder weapon (as well as some red herrings), and the scene of the crime. Once you've deduced the murder weapon, murderer, and room where the murder took place, you win! Just don't run out of time...

If you need help, type "help".

The hall is to your south.

>h
That's not a verb I recognise.

>h
That's not a verb I recognise.

>n
You can't go that way.

>n
You can't go that way.

>s
Hall
The study is to your northwest, the lounge is to your northeast, the ballroom is to your south, the library is to your southwest, and the dining room is to your southeast.

* * *

>n
Don't leave yet, detective! There is still a mystery to solve!

>s
Ballroom

>n
Hall
The study is to your northwest, the lounge is to your northeast, the ballroom is to your south, the library is to your southwest, and the dining room is to your southeast.

* * *

>h
That's not a verb I recognise.

>n
Don't leave yet, detective! There is still a mystery to solve!

>n
Don't leave yet, detective! There is still a mystery to solve!

I beg your pardon?

I beg your pardon?

>n
Don't leave yet, detective! There is still a mystery to solve!

* * *

Clue
An Interactive Fiction by the Andersons
Release 1 / Serial number 231122 / Inform 7 v10.1.2 / D

Entryway
Welcome to Clue! Your name is Detective Black. You are investigating a murder in the Mystery Mansion. You can move around the mansion, find suspects, the murder weapon (as well as some red herrings), and the scene of the crime. Once you've deduced the murder weapon, murderer, and room where the murder took place, you win! Just don't run out of time...

If you need help, type "help".

The hall is to your south.

>help
To move around, you can enter the direction you want to go. For example: north, south, east, west, northwest, northeast, southwest, southeast, up, or down. You can abbreviate any of these directions with their common abbreviations: n, s, e, w, etc.

When you see people and objects in rooms, you can look at them by typing "look at <person>" or "look at <object>. For example: "look at Colonel Mustard" or "look at silver candlestick". You may abbreviate the word "look" as "l". Many people and object names can also be shortened. In the example above, for example, you could type "l at Mustard" or "l at candlestick" instead.

In each game, one person, weapon, and room offer a clue that they were involved in the murder. It's your goal to identify the person, place, and weapon used.

>aaa
That's not a verb I recognise.

* * *

>s
Hall
The hall is a great central room in the mansion. You can see a wooden side table holding a bowl of fruit, flanked with chairs. On another table is a vase containing flowers. Beside it sits a Queen Anne armchair. A golden mirror hangs on a wall. A massive Persian rug is in the middle of the room.

The study is to your northwest, the lounge is to your northeast, the ballroom is to your south, the library is to your southwest, and the dining room is to your southeast.

You can see a thin rope here.

>l around hall
You can't see any such thing.

>l around room
You can't see any such thing.

>l at room
You can't see any such thing.

* * *

>s
Hall
The hall is a great central room in the mansion. You can see a wooden side table holding a bowl of fruit, flanked with chairs. On another table is a vase containing flowers. Beside it sits a Queen Anne armchair. A golden mirror hangs on a wall. A massive Persian rug is in the middle of the room.

The study is to your northwest, the lounge is to your northeast, the ballroom is to your south, the library is to your southwest, and the dining room is to your southeast.

You can see a thin rope here.

>l at rope
A thin, but sturdy rope.

>sw
Library
The study is to your north, the hall is to your east, and the billiard room is to your south.

You can see Mr Green here.

>l at green
Mr Green has blood spots on his sleeve!

[Your score has just gone up by ten points.]

>score
You have so far scored 10 out of a possible 50, in 5 turns.

>e
Hall
The hall is a great central room in the mansion. You can see a wooden side table holding a bowl of fruit, flanked with chairs. On another table is a vase containing flowers. Beside it sits a Queen Anne armchair. A golden mirror hangs on a wall. A massive Persian rug is in the middle of the room.

The study is to your northwest, the lounge is to your northeast, the ballroom is to your south, the library is to your southwest, and the dining room is to your southeast.

You can see a thin rope here.

Mrs White arrives from Study.

>take rope
Taken.

>i
You are carrying:
  a thin rope

>l around
It looks like the floors are a bit dusty.

Mrs White heads to Ballroom.

>ne
Lounge
The lounge is a comfortable place to sit and chat. The centerpiece is a long, comfortable sofa.

The hall is to your west, and the dining room is to your south.

You can see a bronze candlestick here.

>l at candlestick
A solid candlestick, perfect for entertaining.

>bro
That's not a verb I recognise.

>s
Dining room
The hall is to your northwest, the ballroom is to your southwest, the lounge is to your north, and the kitchen is to the south.

You can see Mrs White, Colonel Mustard and Professor Plum here.

>n
Lounge
The lounge is a comfortable place to sit and chat. The centerpiece is a long, comfortable sofa.

The hall is to your west, and the dining room is to your south.

You can see a bronze candlestick here.

>l around
You don't see anything of note.

>s
Dining room
The hall is to your northwest, the ballroom is to your southwest, the lounge is to your north, and the kitchen is to the south.

You can see Mrs White and Professor Plum here.

>l around
You don't see anything of note.

* * *

>s
Hall
The hall is a great central room in the mansion. You can see a wooden side table holding a bowl of fruit, flanked with chairs. On another table is a vase containing flowers. Beside it sits a Queen Anne armchair. A golden mirror hangs on a wall. A massive Persian rug is in the middle of the room.

The study is to your northwest, the lounge is to your northeast, the ballroom is to your south, the library is to your southwest, and the dining room is to your southeast.

You can see a thin rope here.

>nw
Study
The hall is to your east, and the library is to your south.

You can see a bronze candlestick here.

>l at pocketknife
You can't see any such thing.

>d
Kitchen
The dining room is to the north, the ballroom is to the west.

You can see a thin rope, a small pistol and a pocketknife here.

>l at wrench
You can't see any such thing.

>l at lugwrench
You can't see any such thing.

>l at miss scarlet
You can't see any such thing.

>w
Ballroom
The billiard room is to the northwest, the hall is to the north, the dining room is to the northeast, the conservatory is to the southwest, and the kitchen is to the southeast.

* * *

Clue
An Interactive Fiction by the Andersons
Release 1 / Serial number 231122 / Inform 7 v10.1.2 / D

Entryway
Welcome to Clue! Your name is Detective Black. You are investigating a murder in the Mystery Mansion. You can move around the mansion, find suspects, the murder weapon (as well as some red herrings), and the scene of the crime. Once you've deduced the murder weapon, murderer, and room where the murder took place, you win! Just don't run out of time...

If you need help, type "help".

The hall is to your south.

>hi
That's not a verb I recognise.

>go eat pie
You can't see any such thing.

>see ya! bye
That's not a verb I recognise.

* * *

Clue
An Interactive Fiction by the Andersons
Release 1 / Serial number 231122 / Inform 7 v10.1.2 / D

Entryway
Welcome to Clue! Your name is Detective Black. You are investigating a murder in the Mystery Mansion. You can move around the mansion, find suspects, the murder weapon (as well as some red herrings), and the scene of the crime. Once you've deduced the murder weapon, murderer, and room where the murder took place, you win! Just don't run out of time...

If you need help, type "help".

The hall is to your south.

>hlep
That's not a verb I recognise.

I beg your pardon?

* * *

Clue
An Interactive Fiction by the Andersons
Release 1 / Serial number 231122 / Inform 7 v10.1.2 / D

Entryway
Welcome to Clue! Your name is Detective Black. You are investigating a murder in the Mystery Mansion. You can move around the mansion, find suspects, the murder weapon (as well as some red herrings), and the scene of the crime. Once you've deduced the murder weapon, murderer, and room where the murder took place, you win! Just don't run out of time...

If you need help, type "help".

The hall is to your south.

>l
Entryway
Welcome to Clue! Your name is Detective Black. You are investigating a murder in the Mystery Mansion. You can move around the mansion, find suspects, possible murder weapons, and the scene of the crime. Once you've deduced the murder weapon, murderer, and room where the murder took place...

If you need help, type "help".

The hall is to your south.

>s
Hall
The study is to your northwest, the lounge is to your northeast, the ballroom is to your south, the library is to your southwest, and the dining room is to your southeast.

You can see Ms Peacock and Miss Scarlet here.

>l around
It looks like the floors are a bit dusty.

>w
Study
The hall is to your east, and the library is to your south.

>l around
You don't see anything of note.

>s
Library
The study is to your north, the hall is to your east, and the billiard room is to your south.

You can see a pocketknife here.

>l around
It looks like the floors are a bit dusty.

>s
Billiard Room
The library is to the north, the ballroom is to the east, the conservatory is to the south.

You can see a heavy gray handgun and a bronze candlestick here.

>l around
It looks like the floors are a bit dusty.

>s
Conservatory
The ballroom is to the east. The billiard room is to the north.

>l around
It looks like the floors are a bit dusty.

>e
Ballroom
The billiard room is to the northwest, the hall is to the north, the dining room is to the northeast, the conservatory is to the southwest, and the kitchen is to the southeast.

You can see a lugwrench, a thin rope and Mr Green here.

>l around
You found blood spots on the floor!

* * *

Clue
An Interactive Fiction by the Andersons
Release 1 / Serial number 231122 / Inform 7 v10.1.2 / D

Entryway
Welcome to Clue! Your name is Detective Black. You are investigating a murder in the Mystery Mansion. You can move around the mansion, find suspects, the murder weapon (as well as some red herrings), and the scene of the crime. Once you've deduced the murder weapon, murderer, and room where the murder took place, you win! Just don't run out of time...

If you need help, type "help".

The hall is to your south.

>l at floor
You don't see anything of note.

>s
Hall
The study is to your northwest, the lounge is to your northeast, the ballroom is to your south, the library is to your southwest, and the dining room is to your southeast.

You can see a small pistol here.

>l at floor
It looks like the floors are a bit dusty.

>w
Study
The hall is to your east, and the library is to your south.

>l at floor
You found blood spots on the floor!

* * *

Clue
An Interactive Fiction by the Andersons
Release 1 / Serial number 231122 / Inform 7 v10.1.2 / D

Entryway
Welcome to Clue! Your name is Detective Black. You are investigating a murder in the Mystery Mansion. You can move around the mansion, find suspects, the murder weapon (as well as some red herrings), and the scene of the crime. Once you've deduced the murder weapon, murderer, and room where the murder took place, you win! Just don't run out of time...

If you need help, type "help".

The hall is to your south.

>n
You can't go that way.

>s
Hall
The study is to your northwest, the lounge is to your northeast, the ballroom is to your south, the library is to your southwest, and the dining room is to your southeast.

You can see Mrs White and Professor Plum here.

>l at mrs white
You see nothing special about Mrs White.

>l at professor plum
You see nothing special about Professor Plum.

>yayyayyya
That's not a verb I recognise.

>nw
Study
The hall is to your east, and the library is to your south.

You can see a thin rope, a heavy gray handgun and Ms Peacock here.

>l at rope
You see nothing special about the thin rope.

>l at gun
You can't see any such thing.

>l at handgun
You see nothing special about the heavy gray handgun.

>l at ms peacock
You see nothing special about Ms Peacock.

>s
Library
The study is to your north, the hall is to your east, and the billiard room is to your south.

You can see a pocketknife here.

* * *

Clue
An Interactive Fiction by the Andersons
Release 1 / Serial number 231122 / Inform 7 v10.1.2 / D

Entryway
Welcome to Clue! Your name is Detective Black. You are investigating a murder in the Mystery Mansion. You can move around the mansion, find suspects, the murder weapon (as well as some red herrings), and the scene of the crime. Once you've deduced the murder weapon, murderer, and room where the murder took place, you win! Just don't run out of time...

If you need help, type "help".

The hall is to your south.

>s
Hall
The hall is a great central room in the mansion. You can see a wooden side table holding a bowl of fruit, flanked with chairs. On another table is a vase containing flowers. Beside it sits a Queen Anne armchair. A golden mirror hangs on a wall. A massive Persian rug is in the middle of the room.

The study is to your northwest, the lounge is to your northeast, the ballroom is to your south, the library is to your southwest, and the dining room is to your southeast.

On the wooden side table is a dull silver candlestick.

I beg your pardon?

>sw
Library
The study is to your north, the hall is to your east, and the billiard room is to your south.

>s
Billiard Room
The library is to the north, the ballroom is to the east, the conservatory is to the south.

You can see a small pistol and Mr Green here.

>l at green
Mr Green is someone who looks weird.

* * *

>s
Hall
The hall is a great central room in the mansion. You can see a wooden side table holding a bowl of fruit, flanked with chairs. On another table is a vase containing flowers. Beside it sits a Queen Anne armchair. A golden mirror hangs on a wall. A massive Persian rug is in the middle of the room.

The study is to your northwest, the lounge is to your northeast, the ballroom is to your south, the library is to your southwest, and the dining room is to your southeast.

On the wooden side table is a dull silver candlestick.

>e
Lounge
The lounge is a comfortable place to sit and chat. The centerpiece is a long, comfortable sofa.

The hall is to your west, and the dining room is to your south.

>l at plum
Professor Plum has blood spots on Professor Plum's sleeve!

* * *

>e
Lounge
The lounge is a comfortable place to sit and chat. The centerpiece is a long, comfortable sofa.

The hall is to your west, and the dining room is to your south.

>l at rope
A thin, but sturdy rope.

* * *

>e
Lounge
The lounge is a comfortable place to sit and chat. The centerpiece is a long, comfortable sofa.

The hall is to your west, and the dining room is to your south.

>s
Dining room
The hall is to your northwest, the ballroom is to your southwest, the lounge is to your north, and the kitchen is to the south.

You can see a dull silver candlestick here.

>e
You can't go that way.

>s
Kitchen
The dining room is to the north, the ballroom is to the west.

>w
Ballroom
The billiard room is to the northwest, the hall is to the north, the dining room is to the northeast, the conservatory is to the southwest, and the kitchen is to the southeast.

You can see Ms Peacock here.

>w
Billiard Room
The library is to the north, the ballroom is to the east, the conservatory is to the south.

You can see a dull silver candlestick here.

>l at candlestick
You see nothing special about the dull silver candlestick.

* * *

>s
Dining room
The hall is to your northwest, the ballroom is to your southwest, the lounge is to your north, and the kitchen is to the south.

You can see a dull silver candlestick here.

>s
Kitchen
The dining room is to the north, the ballroom is to the west.

>l
Kitchen
The dining room is to the north, the ballroom is to the west.

You can see a heavy gray handgun, a dull silver candlestick, Mrs White and Colonel Mustard here.

>w
Ballroom
The billiard room is to the northwest, the hall is to the north, the dining room is to the northeast, the conservatory is to the southwest, and the kitchen is to the southeast.

You can see a lugwrench here.

>l
Ballroom
The billiard room is to the northwest, the hall is to the north, the dining room is to the northeast, the conservatory is to the southwest, and the kitchen is to the southeast.

You can see a lugwrench here.

>w
Billiard Room
The library is to the north, the ballroom is to the east, the conservatory is to the south.

>l
Billiard Room
The library is to the north, the ballroom is to the east, the conservatory is to the south.

>n
Library
The study is to your north, the hall is to your east, and the billiard room is to your south.

You can see a thin rope and a bronze candlestick here.

>l
Library
The study is to your north, the hall is to your east, and the billiard room is to your south.

You can see a thin rope and a bronze candlestick here.

>n
Study
The hall is to your east, and the library is to your south.

You can see Ms Peacock and Mr Green here.

>e
Hall
The study is to your northwest, the lounge is to your northeast, the ballroom is to your south, the library is to your southwest, and the dining room is to your southeast.

You can see a pocketknife here.

>s
Ballroom
The billiard room is to the northwest, the hall is to the north, the dining room is to the northeast, the conservatory is to the southwest, and the kitchen is to the southeast.

You can see a lugwrench here.

>l
Ballroom
The billiard room is to the northwest, the hall is to the north, the dining room is to the northeast, the conservatory is to the southwest, and the kitchen is to the southeast.

You can see a lugwrench here.

>se
Kitchen
The dining room is to the north, the ballroom is to the west.

You can see a heavy gray handgun, a dull silver candlestick, Mrs White and Colonel Mustard here.

>l
Kitchen
The dining room is to the north, the ballroom is to the west.

You can see a heavy gray handgun, a dull silver candlestick, Mrs White and Colonel Mustard here.

* * *

>s
Kitchen
The dining room is to the north, the ballroom is to the west.

>l at mustard
A funny-looking dude.

* * *

>s
Kitchen
The dining room is to the north, the ballroom is to the west.

>s
You can't go that way.

>w
Ballroom
The billiard room is to the northwest, the hall is to the north, the dining room is to the northeast, the conservatory is to the southwest, and the kitchen is to the southeast.

You can see a heavy gray handgun here.

>w
Billiard Room
The library is to the north, the ballroom is to the east, the conservatory is to the south.

It is dull and silver.

You can also see a lugwrench here.

>l at wrench
You can't see any such thing.

* * *

>s
Kitchen
The dining room is to the north, the ballroom is to the west.

>w
Ballroom
The billiard room is to the northwest, the hall is to the north, the dining room is to the northeast, the conservatory is to the southwest, and the kitchen is to the southeast.

You can see a heavy gray handgun, a dull silver candlestick and Colonel Mustard here.

>l at mustard
Colonel Mustard is a funny-looking dude.

* * *

>s
Dining room
The hall is to your northwest, the ballroom is to your southwest, the lounge is to your north, and the kitchen is to the south.

You can see a dull silver candlestick here.

>w
You can't go that way.

>n
Lounge
The lounge is a comfortable place to sit and chat. The centerpiece is a long, comfortable sofa.

The hall is to your west, and the dining room is to your south.

>w
Hall
The hall is a great central room in the mansion. You can see a wooden side table holding a bowl of fruit, flanked with chairs. On another table is a vase containing flowers. Beside it sits a Queen Anne armchair. A golden mirror hangs on a wall. A massive Persian rug is in the middle of the room.

The study is to your northwest, the lounge is to your northeast, the ballroom is to your south, the library is to your southwest, and the dining room is to your southeast.

You can see a thin rope, Mrs White and Mr Green here.

>w
Study
In the center of the dimly lit study is a large wood desk with an ornate armchair. Another armchair sits against the wall. There are several paintings adorning the wall. Someone has lit a fire, which is still smoldering, in the fireplace. Books line shelves along the north and east walls. A rich green carpet, tattered in places, covers the floorboards.

The hall is to your east, and the library is to your south.

You can see a bronze candlestick here.

>s
Library
The study is to your north, the hall is to your east, and the billiard room is to your south.

You can see a small pistol here.

>s
Billiard Room
The library is to the north, the ballroom is to the east, the conservatory is to the south.

>s
Conservatory
The ballroom is to the east. The billiard room is to the north.

You can see Colonel Mustard and Professor Plum here.

the south heads to Lounge.

>z
Time passes.

>z
Time passes.

>l
Conservatory
The ballroom is to the east. The billiard room is to the north.

You can see Professor Plum here.

* * *

>s
Hall
The hall is a great central room in the mansion. You can see a wooden side table holding a bowl of fruit, flanked with chairs. On another table is a vase containing flowers. Beside it sits a Queen Anne armchair. A golden mirror hangs on a wall. A massive Persian rug is in the middle of the room.

The study is to your northwest, the lounge is to your northeast, the ballroom is to your south, the library is to your southwest, and the dining room is to your southeast.

On the wooden side table is a dull silver candlestick.

>go to lounge
You can't see any such thing.

>enter lounge
You can't see any such thing.

>enter Lounge
You can't see any such thing.

>go to Lounge
You can't see any such thing.

* * *

>s
Hall
The hall is a great central room in the mansion. You can see a wooden side table holding a bowl of fruit, flanked with chairs. On another table is a vase containing flowers. Beside it sits a Queen Anne armchair. A golden mirror hangs on a wall. A massive Persian rug is in the middle of the room.

The study is to your northwest, the lounge is to your northeast, the ballroom is to your south, the library is to your southwest, and the dining room is to your southeast.

On the wooden side table is a dull silver candlestick.

>l
Hall
The study is to your northwest, the lounge is to your northeast, the ballroom is to your south, the library is to your southwest, and the dining room is to your southeast.

You can see a lugwrench and a pocketknife here.

>e
Lounge
The hall is to your west, and the dining room is to your south.

>l
Lounge
The hall is to your west, and the dining room is to your south.

>s
Dining room
The hall is to your northwest, the ballroom is to your southwest, the lounge is to your north, and the kitchen is to the south.

You can see a bronze candlestick, Mrs White, Professor Plum and Colonel Mustard here.

>l
Dining room
The hall is to your northwest, the ballroom is to your southwest, the lounge is to your north, and the kitchen is to the south.

You can see a bronze candlestick, Mrs White, Professor Plum and Colonel Mustard here.

>s
Kitchen
The dining room is to the north, the ballroom is to the west.

>l
Kitchen
The dining room is to the north, the ballroom is to the west.

>examine kitchen
You can't see any such thing.

>l
Kitchen
The dining room is to the north, the ballroom is to the west.

>w
Ballroom
The billiard room is to the northwest, the hall is to the north, the dining room is to the northeast, the conservatory is to the southwest, and the kitchen is to the southeast.

You can see Miss Scarlet and Mr Green here.

>l
Ballroom
The billiard room is to the northwest, the hall is to the north, the dining room is to the northeast, the conservatory is to the southwest, and the kitchen is to the southeast.

You can see Miss Scarlet and Mr Green here.

>w
Billiard Room
The library is to the north, the ballroom is to the east, the conservatory is to the south.

You can see a small pistol here.

>l
Billiard Room
The library is to the north, the ballroom is to the east, the conservatory is to the south.

You can see a small pistol here.

>w
You can't go that way.

>s
Conservatory
The ballroom is to the east. The billiard room is to the north.

You can see Ms Peacock here.

>l
Conservatory
The ballroom is to the east. The billiard room is to the north.

You can see Ms Peacock here.

>n
Billiard Room
The library is to the north, the ballroom is to the east, the conservatory is to the south.

You can see a small pistol here.

>l
Billiard Room
The library is to the north, the ballroom is to the east, the conservatory is to the south.

You can see a small pistol here.

>n
Library
The study is to your north, the hall is to your east, and the billiard room is to your south.

You can see a heavy gray handgun and a dull silver candlestick here.

>l
Library
The study is to your north, the hall is to your east, and the billiard room is to your south.

You can see a heavy gray handgun and a dull silver candlestick here.

>n
Study
The hall is to your east, and the library is to your south.

You can see a thin rope here.

>l
Study
The hall is to your east, and the library is to your south.

You can see a thin rope here.

>e
Hall
The study is to your northwest, the lounge is to your northeast, the ballroom is to your south, the library is to your southwest, and the dining room is to your southeast.

You can see a lugwrench and a pocketknife here.

>l
Hall
The study is to your northwest, the lounge is to your northeast, the ballroom is to your south, the library is to your southwest, and the dining room is to your southeast.

You can see a lugwrench and a pocketknife here.

>l at room
You can't see any such thing.

>l
Hall
The study is to your northwest, the lounge is to your northeast, the ballroom is to your south, the library is to your southwest, and the dining room is to your southeast.

You can see a lugwrench and a pocketknife here.

>n
Don't leave yet, detective! There is still a mystery to solve!

>w
Study
The hall is to your east, and the library is to your south.

You can see a thin rope here.

>l
Study
The hall is to your east, and the library is to your south.

You can see a thin rope here.

>nw
You can't go that way.

>l
Study
The hall is to your east, and the library is to your south.

You can see a thin rope here.

>s
Library
The study is to your north, the hall is to your east, and the billiard room is to your south.

You can see a heavy gray handgun and a dull silver candlestick here.

>l
Library
The study is to your north, the hall is to your east, and the billiard room is to your south.

You can see a heavy gray handgun and a dull silver candlestick here.

>s
Billiard Room
The library is to the north, the ballroom is to the east, the conservatory is to the south.

You can see a small pistol here.

>l
Billiard Room
The library is to the north, the ballroom is to the east, the conservatory is to the south.

You can see a small pistol here.

>s
Conservatory
The ballroom is to the east. The billiard room is to the north.

You can see Ms Peacock here.

* * *

>l
Conservatory
The ballroom is to the east. The billiard room is to the north.

You can see Ms Peacock here.

>e
Ballroom
The billiard room is to the northwest, the hall is to the north, the dining room is to the northeast, the conservatory is to the southwest, and the kitchen is to the southeast.

You can see Miss Scarlet and Mr Green here.

>l
Ballroom
The billiard room is to the northwest, the hall is to the north, the dining room is to the northeast, the conservatory is to the southwest, and the kitchen is to the southeast.

You can see Miss Scarlet and Mr Green here.

>e
Kitchen
The dining room is to the north, the ballroom is to the west.

>l
Kitchen
The dining room is to the north, the ballroom is to the west.

>n
Dining room
The hall is to your northwest, the ballroom is to your southwest, the lounge is to your north, and the kitchen is to the south.

You can see a bronze candlestick, Mrs White, Professor Plum and Colonel Mustard here.

>l
Dining room
The hall is to your northwest, the ballroom is to your southwest, the lounge is to your north, and the kitchen is to the south.

You can see a bronze candlestick, Mrs White, Professor Plum and Colonel Mustard here.

>n
Lounge
The hall is to your west, and the dining room is to your south.

>l
Lounge
The hall is to your west, and the dining room is to your south.

>look around
You can't see any such thing.

* * *

>s
Hall
The hall is a great central room in the mansion. You can see a wooden side table holding a bowl of fruit, flanked with chairs. On another table is a vase containing flowers. Beside it sits a Queen Anne armchair. A golden mirror hangs on a wall. A massive Persian rug is in the middle of the room.

The study is to your northwest, the lounge is to your northeast, the ballroom is to your south, the library is to your southwest, and the dining room is to your southeast.

On the wooden side table is a dull silver candlestick.

>l around
It looks like the floors are a bit dusty .

* * *

>s
Hall
The hall is a great central room in the mansion. You can see a wooden side table holding a bowl of fruit, flanked with chairs. On another table is a vase containing flowers. Beside it sits a Queen Anne armchair. A golden mirror hangs on a wall. A massive Persian rug is in the middle of the room.

The study is to your northwest, the lounge is to your northeast, the ballroom is to your south, the library is to your southwest, and the dining room is to your southeast.

On the wooden side table is a dull silver candlestick.

>l at candlestick
It could use a little polish.

>l at table
Which do you mean, the wooden side table or the dusty wood table?

>side table
On the wooden side table is a dull silver candlestick.

>l at table
Which do you mean, the wooden side table or the dusty wood table?

>dusty
You see nothing special about the dusty wood table.

Mr Green arrives from the dining room.

>l at green
Mr Green is wearing a tan suit with a green tie.

Mr Green heads to the study.

>go to study
You walk to the study.

study
In the center of the dimly lit study is a large wood desk with an ornate armchair. Another armchair sits against the wall. There are several paintings adorning the wall. Someone has lit a fire, which is still smoldering, in the fireplace. Books line shelves along the north and east walls. A rich green carpet, tattered in places, covers the floorboards.

The hall is to your east, and the library is to your south.

You can see Mr Green, Mrs White and Colonel Mustard here.

>l at white
Mrs White is wearing a black dress, fringed with decorative white lace.

Colonel Mustard heads to the kitchen.

>l at armchair
You see nothing special about the ornate armchair.

>l
study
In the center of the dimly lit study is a large wood desk with an ornate armchair. Another armchair sits against the wall. There are several paintings adorning the wall. Someone has lit a fire, which is still smoldering, in the fireplace. Books line shelves along the north and east walls. A rich green carpet, tattered in places, covers the floorboards.

The hall is to your east, and the library is to your south.

You can see Mr Green and Mrs White here.

Mrs White heads to the Hall.

Mr Green looks over at you nervously.

>go to kitchen
You walk to the kitchen.

kitchen
You see a kitchen table, a cupboard, and a granite countertop. An industrial refrigerator looms over the room. The dining room is to the north, the ballroom is to the west.

You can see Colonel Mustard here.

Colonel Mustard heads to the dining room.

>l
kitchen
You see a kitchen table, a cupboard, and a granite countertop. An industrial refrigerator looms over the room. The dining room is to the north, the ballroom is to the west.

>look for clues
It looks like the floors are a bit dusty.

>l in cupboard
You can't see inside, since the kitchen cupboard is closed.

>open cupboard
You open the kitchen cupboard.

>l in cupboard
The kitchen cupboard is empty.

>open fride
You can't see any such thing.

>open fridge
You can't see any such thing.

>open refridgerator
You can't see any such thing.

>open refrigerator
You open the refrigerator.

>l in refrigerator
The refrigerator is empty.

>w
ballroom
A piano, a red sofa, a curved purple sofa, two high-backed chairs, a curio cabinet, and wall sconces are in the ballroom.

The billiard room is to the northwest, the hall is to the north, the dining room is to the northeast, the conservatory is to the southwest, and the kitchen is to the southeast.

>l at piano
You see nothing special about the piano.

>l for clues
It looks like the floors are a bit dusty.

>l at sofa
Which do you mean, the red sofa or the curved purple sofa?

>red
You see nothing special about the red sofa.

>l at purple
You see nothing special about the curved purple sofa.

>l at sconce
You can't see any such thing.

>l at sconces
You see nothing special about wall sconces.

>l at cabinet
You see nothing special about the curio cabinet.

>sw
Conservatory
The conservatory is home to a wide variety of potted plants of all sizes. The heat and humidity are high to keep some of the more exotic species comfortable. Two entire walls of the conservatory are windowed. A utility closet and sink sit on opposite corners of the room, and a yellow bench rests against the windows of one wall.

The ballroom is to the east. The billiard room is to the north.

>l for clues
It looks like the floors are a bit dusty.

Colonel Mustard arrives from the billiard room.

Colonel Mustard looks pale.

>interrogate
That's not a verb I recognise.

>debug
The crimescene is the Hall.
The murderer is Professor Plum.
The murder weapon is the heavy gray handgun.

putting dull silver candlestick on dining room table.
putting bronze candlestick inside curio cabinet.
putting pocket knife inside china cabinet.
putting butcher knife inside assortment of potted plants.
putting small pistol under rich green carpet.
putting heavy gray handgun under chairs.
putting thin rope under hard dark brown chair.
putting braided curtain tie inside fireplace.
putting lugwrench under rich green carpet.
putting pipe wrench under cushioned bench.
putting lead pipe under chairs.
putting dull silver candlestick on wooden side table.
putting bronze candlestick on A well-used table.
putting murder weapon heavy gray handgun in the utility closet.

>go to hall
That noun did not make sense in this context.

>l at closet
You see nothing special about the utility closet.

>open closet
You open the utility closet, revealing a heavy gray handgun.

>l at gun
A big gun for doing a lot of damage.

The heavy gray handgun is covered in blood!

[Your score has just gone up by ten points.]

>s
You can't go that way.

>e
ballroom
A piano, a red sofa, a curved purple sofa, two high-backed chairs, a curio cabinet, and wall sconces are in the ballroom.

The billiard room is to the northwest, the hall is to the north, the dining room is to the northeast, the conservatory is to the southwest, and the kitchen is to the southeast.

You hear a distant grandfather clock chime eight times.

>w
billiard room
A billiard table is the centerpiece of the billiard room, its green surface slightly discolored with age. You also see a blue armchair and a rack of cue sticks.

The library is to the north, the ballroom is to the east, the conservatory is to the south.

You can see Mr Green and Professor Plum here.

Colonel Mustard arrives from the Conservatory.

Professor Plum looks over at you nervously.

I beg your pardon?

>a
That's not a verb I recognise.

>e
ballroom
A piano, a red sofa, a curved purple sofa, two high-backed chairs, a curio cabinet, and wall sconces are in the ballroom.

The billiard room is to the northwest, the hall is to the north, the dining room is to the northeast, the conservatory is to the southwest, and the kitchen is to the southeast.

>nw
billiard room
A billiard table is the centerpiece of the billiard room, its green surface slightly discolored with age. You also see a blue armchair and a rack of cue sticks.

The library is to the north, the ballroom is to the east, the conservatory is to the south.

You can see Colonel Mustard and Mr Green here.

>s
Conservatory
The conservatory is home to a wide variety of potted plants of all sizes. The heat and humidity are high to keep some of the more exotic species comfortable. Two entire walls of the conservatory are windowed. A utility closet and sink sit on opposite corners of the room, and a yellow bench rests against the windows of one wall.

The ballroom is to the east. The billiard room is to the north.

>e
ballroom
A piano, a red sofa, a curved purple sofa, two high-backed chairs, a curio cabinet, and wall sconces are in the ballroom.

The billiard room is to the northwest, the hall is to the north, the dining room is to the northeast, the conservatory is to the southwest, and the kitchen is to the southeast.

Colonel Mustard arrives from the billiard room.

I beg your pardon?

>w
billiard room
A billiard table is the centerpiece of the billiard room, its green surface slightly discolored with age. You also see a blue armchair and a rack of cue sticks.

The library is to the north, the ballroom is to the east, the conservatory is to the south.

You can see Mr Green here.

Mr Green heads to the ballroom.

>n
library
In the library you see bookcases, a green-tinted lamp, a hard dark brown chair, A well-used table, a roaring fireplace, a threadbare armchair, a rumpled couch, a solid wood bench, and a stool.

The study is to your north, the hall is to your east, and the billiard room is to your south.

On A well-used table is a bronze candlestick.

>a
That's not a verb I recognise.

>e
Hall
The hall is a great central room in the mansion. You can see a wooden side table holding a bowl of fruit, flanked with chairs. On another table is a vase containing flowers. Beside it sits a Queen Anne armchair. A golden mirror hangs on a wall. A massive Persian rug is in the middle of the room.

The study is to your northwest, the lounge is to your northeast, the ballroom is to your south, the library is to your southwest, and the dining room is to your southeast.

On the wooden side table is a dull silver candlestick.

You can also see Miss Scarlet here.

Miss Scarlet heads to the library.

>l for clues
You found blood spots on the floor!

[Your score has just gone up by ten points.]

>s
ballroom
A piano, a red sofa, a curved purple sofa, two high-backed chairs, a curio cabinet, and wall sconces are in the ballroom.

The billiard room is to the northwest, the hall is to the north, the dining room is to the northeast, the conservatory is to the southwest, and the kitchen is to the southeast.

You can see Colonel Mustard here.

Mr Green arrives from the dining room.

Colonel Mustard looks over at you nervously.

>s
You can't go that way.

Mr Green looks pale.

>n
Hall
The hall is a great central room in the mansion. You can see a wooden side table holding a bowl of fruit, flanked with chairs. On another table is a vase containing flowers. Beside it sits a Queen Anne armchair. A golden mirror hangs on a wall. A massive Persian rug is in the middle of the room.

The study is to your northwest, the lounge is to your northeast, the ballroom is to your south, the library is to your southwest, and the dining room is to your southeast.

On the wooden side table is a dull silver candlestick.

>s
ballroom
A piano, a red sofa, a curved purple sofa, two high-backed chairs, a curio cabinet, and wall sconces are in the ballroom.

The billiard room is to the northwest, the hall is to the north, the dining room is to the northeast, the conservatory is to the southwest, and the kitchen is to the southeast.

You can see Mr Green and Colonel Mustard here.

>e
kitchen
You see a kitchen table, a cupboard, and a granite countertop. An industrial refrigerator looms over the room. The dining room is to the north, the ballroom is to the west.

>e
You can't go that way.

>w
ballroom
A piano, a red sofa, a curved purple sofa, two high-backed chairs, a curio cabinet, and wall sconces are in the ballroom.

The billiard room is to the northwest, the hall is to the north, the dining room is to the northeast, the conservatory is to the southwest, and the kitchen is to the southeast.

You can see Colonel Mustard here.

>w
billiard room
A billiard table is the centerpiece of the billiard room, its green surface slightly discolored with age. You also see a blue armchair and a rack of cue sticks.

The library is to the north, the ballroom is to the east, the conservatory is to the south.

You can see Miss Scarlet here.

Ms Peacock arrives from the library.

You hear a car engine start in the courtyard and pull away. Professor Plum has escaped. (He used the heavy gray handgun in the Hall.)

    *** The End ***

In that game you scored 20 out of a possible 30, in 48 turns.

Would you like to RESTART, RESTORE a saved game, QUIT or UNDO the last command?

* * *

>l at candlestick
It could use a little polish.

>nw
Study
The hall is to your east, and the library is to your south.

You can see a heavy gray handgun and Colonel Mustard here.

>l at handgun
You see nothing special about the heavy gray handgun.

>l at mustard
You see nothing special about Colonel Mustard.

>s
Library
The study is to your north, the hall is to your east, and the billiard room is to your south.

You can see a pocket knife here.

>l at knife
You see nothing special about the pocket knife.

>s
Billiard Room
The library is to the north, the ballroom is to the east, the conservatory is to the south.

>e
Ballroom
The billiard room is to the northwest, the hall is to the north, the dining room is to the northeast, the conservatory is to the southwest, and the kitchen is to the southeast.

You can see a bronze candlestick here.

>l around
You don't see anything of note.

>l at candlestick
You see nothing special about the bronze candlestick.

* * *

>nw
Study
The hall is to your east, and the library is to your south.

You can see a heavy gray handgun and Colonel Mustard here.

>l at rope
You see nothing special about the thin rope.

>ne
You can't go that way.

>s
Library
The study is to your north, the hall is to your east, and the billiard room is to your south.

You can see a bronze candlestick here.

>l at candlestick
You see nothing special about the bronze candlestick.

>s
Billiard Room
The library is to the north, the ballroom is to the east, the conservatory is to the south.

You can see a pocketknife here.

>l at knife
You can't see any such thing.

>l at pocketknife
You see nothing special about the pocketknife.

>s
Conservatory
The ballroom is to the east. The billiard room is to the north.

You can see Mr Green here.

>l at green
You see nothing special about Mr Green.

I beg your pardon?

>e
Ballroom
The billiard room is to the northwest, the hall is to the north, the dining room is to the northeast, the conservatory is to the southwest, and the kitchen is to the southeast.

You can see a lugwrench, a heavy gray handgun, a small pistol and Colonel Mustard here.

>l at lugwrench
You see nothing special about the lugwrench.

>l at handgun
You see nothing special about the heavy gray handgun.

>l at pistol
The small pistol is covered in blood!

>l at mustard
You see nothing special about Colonel Mustard.

>se
Kitchen
The dining room is to the north, the ballroom is to the west.

You can see Miss Scarlet and Professor Plum here.

>l at scarlet
Miss Scarlet has blood spots on her sleeve!

>ms scarlet with small pistol...
That's not a verb I recognise.

>w
Ballroom
The billiard room is to the northwest, the hall is to the north, the dining room is to the northeast, the conservatory is to the southwest, and the kitchen is to the southeast.

You can see a lugwrench, a heavy gray handgun, a small pistol and Colonel Mustard here.

>ne
Dining room
The hall is to your northwest, the ballroom is to your southwest, the lounge is to your north, and the kitchen is to the south.

I beg your pardon?

>n
Lounge
The hall is to your west, and the dining room is to your south.

You can see Ms Peacock and Mrs White here.

>d
Conservatory
The ballroom is to the east. The billiard room is to the north.

You can see Mr Green here.

>d\
That's not a verb I recognise.

>d
Lounge
The hall is to your west, and the dining room is to your south.

You can see Ms Peacock and Mrs White here.

>d
Conservatory
The ballroom is to the east. The billiard room is to the north.

You can see Mr Green here.

>d
Lounge
The hall is to your west, and the dining room is to your south.

You can see Ms Peacock and Mrs White here.

I beg your pardon?

>dd
That's not a verb I recognise.

>d
Conservatory
The ballroom is to the east. The billiard room is to the north.

You can see Mr Green here.

I beg your pardon?

>d
Lounge
The hall is to your west, and the dining room is to your south.

You can see Ms Peacock and Mrs White here.

* * *

I beg your pardon?

>ddd
That's not a verb I recognise.

>d
Conservatory
The ballroom is to the east. The billiard room is to the north.

You can see Mr Green here.

* * *

I beg your pardon?

>d
Conservatory
The ballroom is to the east. The billiard room is to the north.

You can see Mr Green here.

* * *

>d
Lounge
The hall is to your west, and the dining room is to your south.

You can see Ms Peacock and Mrs White here.

>dd
That's not a verb I recognise.

* * *

I beg your pardon?

>l at candlestick
You can't see any such thing.

>d
Conservatory
The ballroom is to the east. The billiard room is to the north.

You can see Mr Green here.

>up
You can't go that way.

>up
You can't go that way.

>u
You can't go that way.

>up
You can't go that way.

>upppppppppppppppppppppppppppppp
That's not a verb I recognise.

* * *

>s
Hall
The hall is a great central room in the mansion. You can see a wooden side table holding a bowl of fruit, flanked with chairs. On another table is a vase containing flowers. Beside it sits a Queen Anne armchair. A golden mirror hangs on a wall. A massive Persian rug is in the middle of the room.

The study is to your northwest, the lounge is to your northeast, the ballroom is to your south, the library is to your southwest, and the dining room is to your southeast.

On the wooden side table is a dull silver candlestick.

>l at dull
It could use a little polish.

>e
Lounge
The hall is to your west, and the dining room is to your south.

You can see a small pistol here.

>l at pistol
A purse-sized pistol.

>s
Dining room
The hall is to your northwest, the ballroom is to your southwest, the lounge is to your north, and the kitchen is to the south.

You can see a heavy gray handgun and a pocket knife here.

>l at handgun
The heavy gray handgun is covered in blood!

* * *

>s
Hall
The hall is a great central room in the mansion. You can see a wooden side table holding a bowl of fruit, flanked with chairs. On another table is a vase containing flowers. Beside it sits a Queen Anne armchair. A golden mirror hangs on a wall. A massive Persian rug is in the middle of the room.

The study is to your northwest, the lounge is to your northeast, the ballroom is to your south, the library is to your southwest, and the dining room is to your southeast.

On the wooden side table is a dull silver candlestick.

>l at green
You see nothing special about Mr Green.

>e
Lounge
The hall is to your west, and the dining room is to your south.

You can see a heavy gray handgun and a pocketknife here.

>l at handgun
You see nothing special about the heavy gray handgun.

>l at pocketknife
You see nothing special about the pocketknife.

>s
Dining room
The hall is to your northwest, the ballroom is to your southwest, the lounge is to your north, and the kitchen is to the south.

You can see a thin rope, a dull silver candlestick and Colonel Mustard here.

>l at rope
The thin rope is covered in blood!

* * *

>s
Hall
The hall is a great central room in the mansion. You can see a wooden side table holding a bowl of fruit, flanked with chairs. On another table is a vase containing flowers. Beside it sits a Queen Anne armchair. A golden mirror hangs on a wall. A massive Persian rug is in the middle of the room.

The study is to your northwest, the lounge is to your northeast, the ballroom is to your south, the library is to your southwest, and the dining room is to your southeast.

On the wooden side table is a dull silver candlestick.

>l at knife
A knife just like the one you had in Scouts.

>e
Lounge
The lounge is a comfortable place to sit and chat. The centerpiece is a long, comfortable sofa.

The hall is to your west, and the dining room is to your south.

You can see a lugwrench, Professor Plum and Colonel Mustard here.

>l at lugwrench
A heavy wrench for removing bolts.

>l at plum
Professor Plum is someone who looks weird.

>l at mustard
Colonel Mustard is someone who looks weird.

>s
Dining room
The hall is to your northwest, the ballroom is to your southwest, the lounge is to your north, and the kitchen is to the south.

You can see a dull silver candlestick and Miss Scarlet here.

>l at scarlet
Miss Scarlet has blood spots on her sleeve!

>l at silver
It could use a little polish.

>l around
You don't see anything of note.

>n
Lounge
The lounge is a comfortable place to sit and chat. The centerpiece is a long, comfortable sofa.

The hall is to your west, and the dining room is to your south.

You can see a lugwrench, Professor Plum and Colonel Mustard here.

>l around
It looks like the floors are a bit dusty.

>w
Hall
The hall is a great central room in the mansion. You can see a wooden side table holding a bowl of fruit, flanked with chairs. On another table is a vase containing flowers. Beside it sits a Queen Anne armchair. A golden mirror hangs on a wall. A massive Persian rug is in the middle of the room.

The study is to your northwest, the lounge is to your northeast, the ballroom is to your south, the library is to your southwest, and the dining room is to your southeast.

You can see a pocket knife here.

>l around
It looks like the floors are a bit dusty.

>s
Ballroom
The billiard room is to the northwest, the hall is to the north, the dining room is to the northeast, the conservatory is to the southwest, and the kitchen is to the southeast.

>l around
You don't see anything of note.

>s
You can't go that way.

>w
Billiard Room
The library is to the north, the ballroom is to the east, the conservatory is to the south.

You can see a small pistol and Mr Green here.

>l around
You don't see anything of note.

>n
Library
The study is to your north, the hall is to your east, and the billiard room is to your south.

>l around
You don't see anything of note.

>n
Study
In the center of the dimly lit study is a large wood desk with an ornate armchair. Another armchair sits against the wall. There are several paintings adorning the wall. Someone has lit a fire, which is still smoldering, in the fireplace. Books line shelves along the north and east walls. A rich green carpet, tattered in places, covers the floorboards.

The hall is to your east, and the library is to your south.

You can see a thin rope, a bronze candlestick, Ms Peacock and Mrs White here.

>l around
You found blood spots on the floor!

>l at rope
A thin, but sturdy rope.

>l a candlestick
The bronze candlestick is covered in blood!

* * *

>s
Hall
The hall is a great central room in the mansion. You can see a wooden side table holding a bowl of fruit, flanked with chairs. On another table is a vase containing flowers. Beside it sits a Queen Anne armchair. A golden mirror hangs on a wall. A massive Persian rug is in the middle of the room.

The study is to your northwest, the lounge is to your northeast, the ballroom is to your south, the library is to your southwest, and the dining room is to your southeast.

On the wooden side table is a dull silver candlestick.

>l at ms peacock
You see nothing special about Ms Peacock.

>e
Lounge
The hall is to your west, and the dining room is to your south.

You can see Mr Green here.

>l at mr green
Mr Green has blood spots on their sleeve!

* * *

>s
Hall
The hall is a great central room in the mansion. You can see a wooden side table holding a bowl of fruit, flanked with chairs. On another table is a vase containing flowers. Beside it sits a Queen Anne armchair. A golden mirror hangs on a wall. A massive Persian rug is in the middle of the room.

The study is to your northwest, the lounge is to your northeast, the ballroom is to your south, the library is to your southwest, and the dining room is to your southeast.

On the wooden side table is a dull silver candlestick.

>l at mustard
Colonel Mustard has blood spots on his sleeve!

[Your score has just gone up by ten points.]

>l at peacock
You can't see any such thing.

>l at scarlet
Miss Scarlet has blood spots on her sleeve!

* * *

>l at mustard
Colonel Mustard has blood spots on his sleeve!

[Your score has just gone up by ten points.]

>l at plum
You see nothing special about Professor Plum.

>l at scarlet
You see nothing special about Miss Scarlet.

>l at white
Mrs White has blood spots on their sleeve!

* * *

>s
Hall
The hall is a great central room in the mansion. You can see a wooden side table holding a bowl of fruit, flanked with chairs. On another table is a vase containing flowers. Beside it sits a Queen Anne armchair. A golden mirror hangs on a wall. A massive Persian rug is in the middle of the room.

The study is to your northwest, the lounge is to your northeast, the ballroom is to your south, the library is to your southwest, and the dining room is to your southeast.

On the wooden side table is a dull silver candlestick.

>l at peacock
You see nothing special about Ms Peacock.

>s
Ballroom
The billiard room is to the northwest, the hall is to the north, the dining room is to the northeast, the conservatory is to the southwest, and the kitchen is to the southeast.

You can see Mr Green and Professor Plum here.

>l at green
You see nothing special about Mr Green.

>l at plum
You see nothing special about Professor Plum.

>s
You can't go that way.

>e
Kitchen
The dining room is to the north, the ballroom is to the west.

>n
Dining room
The hall is to your northwest, the ballroom is to your southwest, the lounge is to your north, and the kitchen is to the south.

>n
Lounge
The hall is to your west, and the dining room is to your south.

You can see Mrs White here.

>l at white
Mrs White has blood spots on your sleeve!

* * *

>s
Hall
The hall is a great central room in the mansion. You can see a wooden side table holding a bowl of fruit, flanked with chairs. On another table is a vase containing flowers. Beside it sits a Queen Anne armchair. A golden mirror hangs on a wall. A massive Persian rug is in the middle of the room.

The study is to your northwest, the lounge is to your northeast, the ballroom is to your south, the library is to your southwest, and the dining room is to your southeast.

On the wooden side table is a dull silver candlestick.

>l at ps peacock
You can't see any such thing.

>l at ms peacock
You see nothing special about Ms Peacock.

>l at green
Mr Green has blood spots on their sleeve!

* * *

>s
Hall
The hall is a great central room in the mansion. You can see a wooden side table holding a bowl of fruit, flanked with chairs. On another table is a vase containing flowers. Beside it sits a Queen Anne armchair. A golden mirror hangs on a wall. A massive Persian rug is in the middle of the room.

The study is to your northwest, the lounge is to your northeast, the ballroom is to your south, the library is to your southwest, and the dining room is to your southeast.

On the wooden side table is a dull silver candlestick.

>l at rug
You see nothing special about the rug.

* * *

>s
Hall
The hall is a great central room in the mansion. You can see a wooden side table holding a bowl of fruit, flanked with chairs. On another table is a vase containing flowers. Beside it sits a Queen Anne armchair. A golden mirror hangs on a wall. A massive Persian rug is in the middle of the room.

The study is to your northwest, the lounge is to your northeast, the ballroom is to your south, the library is to your southwest, and the dining room is to your southeast.

On the wooden side table is a dull silver candlestick.

>l at tabke
You can't see any such thing.

>l at table
Which do you mean, the wooden side table or the dusty wood table?

* * *

>s
Hall
The hall is a great central room in the mansion. You can see a wooden side table holding a bowl of fruit, flanked with chairs. On another table is a vase containing flowers. Beside it sits a Queen Anne armchair. A golden mirror hangs on a wall. A massive Persian rug is in the middle of the room.

The study is to your northwest, the lounge is to your northeast, the ballroom is to your south, the library is to your southwest, and the dining room is to your southeast.

On the wooden side table is a dull silver candlestick.

>l at white
You see nothing special about Mrs White.

>e
Lounge
The hall is to your west, and the dining room is to your south.

You can see a dull silver candlestick here.

>l at candlestick
You see nothing special about the dull silver candlestick.

>s
Dining room
The hall is to your northwest, the ballroom is to your southwest, the lounge is to your north, and the kitchen is to the south.

You can see a bronze candlestick and Mr Green here.

>l at candlestick
The bronze candlestick is covered in blood!

>l at green
You see nothing special about Mr Green.

>s
Kitchen
The dining room is to the north, the ballroom is to the west.

>w
Ballroom
The billiard room is to the northwest, the hall is to the north, the dining room is to the northeast, the conservatory is to the southwest, and the kitchen is to the southeast.

You can see a heavy gray handgun here.

>l at handgun
You see nothing special about the heavy gray handgun.

>w
Billiard Room
The library is to the north, the ballroom is to the east, the conservatory is to the south.

You can see a small pistol, Ms Peacock and Colonel Mustard here.

>l a pistol
You see nothing special about the small pistol.

>l at peacock
You see nothing special about Ms Peacock.

>l at mustard
You see nothing special about Colonel Mustard.

>w
You can't go that way.

>n
Library
The study is to your north, the hall is to your east, and the billiard room is to your south.

You can see a pocketknife, Miss Scarlet and Professor Plum here.

>l at pcketknife
You can't see any such thing.

>l at pocketknife
You see nothing special about the pocketknife.

>l at scarlet
Miss Scarlet has blood spots on her sleeve!

* * *

>w
Study
The hall is to your east, and the library is to your south.

You can see a small pistol and a dull silver candlestick here.

* * *

>s
Library
The study is to your north, the hall is to your east, and the billiard room is to your south.

You can see Mr Green here.

* * *

>s
Billiard Room
The library is to the north, the ballroom is to the east, the conservatory is to the south.

You can see Professor Plum and Colonel Mustard here.

* * *

>s
Conservatory
The ballroom is to the east. The billiard room is to the north.

* * *

>e
Ballroom
The billiard room is to the northwest, the hall is to the north, the dining room is to the northeast, the conservatory is to the southwest, and the kitchen is to the southeast.

You can see a heavy gray handgun here.

* * *

>n
Hall
The study is to your northwest, the lounge is to your northeast, the ballroom is to your south, the library is to your southwest, and the dining room is to your southeast.

You can see a pocketknife here.

* * *

>e
Lounge
The hall is to your west, and the dining room is to your south.

You can see a lugwrench, a thin rope and Ms Peacock here.

* * *

>s
Dining room
The hall is to your northwest, the ballroom is to your southwest, the lounge is to your north, and the kitchen is to the south.

You can see Mrs White here.

* * *

>s
Kitchen
The dining room is to the north, the ballroom is to the west.

You can see a bronze candlestick and Miss Scarlet here.

>look around
You found blood spots on the floor!

* * *

>s
Hall
The hall is a great central room in the mansion. You can see a wooden side table holding a bowl of fruit, flanked with chairs. On another table is a vase containing flowers. Beside it sits a Queen Anne armchair. A golden mirror hangs on a wall. A massive Persian rug is in the middle of the room.

The study is to your northwest, the lounge is to your northeast, the ballroom is to your south, the library is to your southwest, and the dining room is to your southeast.

On the wooden side table is a dull silver candlestick.

>n
Don't leave yet, detective! There is still a mystery to solve!

>l at plum
You see nothing special about Professor Plum.

>nw
Study
The hall is to your east, and the library is to your south.

You can see a lugwrench, a bronze candlestick, a dull silver candlestick and Colonel Mustard here.

>l at lugwrench
You see nothing special about the lugwrench.

>l at candlestick
Which do you mean, the bronze candlestick or the dull silver candlestick?

>l at bronze candlestick
You see nothing special about the bronze candlestick.

>l at silver candlestick
You see nothing special about the dull silver candlestick.

>l at mustard
You see nothing special about Colonel Mustard.

>s
Library
The study is to your north, the hall is to your east, and the billiard room is to your south.

You can see a heavy gray handgun, a small pistol and Mrs White here.

>l at handgun
The heavy gray handgun is covered in blood!

>l at pistol
You see nothing special about the small pistol.

>l at mrs white
You see nothing special about Mrs White.

>s
Billiard Room
The library is to the north, the ballroom is to the east, the conservatory is to the south.

You can see Mr Green here.

>l at green
Mr Green has blood spots on his sleeve!

>s
Conservatory
The ballroom is to the east. The billiard room is to the north.

You can see Ms Peacock here.

>n
Billiard Room
The library is to the north, the ballroom is to the east, the conservatory is to the south.

You can see Mr Green here.

>s
Conservatory
The ballroom is to the east. The billiard room is to the north.

You can see Ms Peacock here.

>e
Ballroom
The billiard room is to the northwest, the hall is to the north, the dining room is to the northeast, the conservatory is to the southwest, and the kitchen is to the southeast.

You can see a thin rope here.

>l at rope
You see nothing special about the thin rope.

* * *

>n
Don't leave yet, detective! There is still a mystery to solve!

>n
You can't go that way.

>s
Hall

* * *

>n
Don't leave yet, detective! There is still a mystery to solve!

>nw
Study
The hall is to your east, and the library is to your south.

>e
Hall
The study is to your northwest, the lounge is to your northeast, the ballroom is to your south, the library is to your southwest, and the dining room is to your southeast.

>s
Ballroom

>n
Don't leave yet, detective! There is still a mystery to solve!

>s
Hall
The study is to your northwest, the lounge is to your northeast, the ballroom is to your south, the library is to your southwest, and the dining room is to your southeast.

>s
Ballroom

>n
Hall

>sw
Library

* * *

>s
Hall
The hall is a great central room in the mansion. You can see a wooden side table holding a bowl of fruit, flanked with chairs. On another table is a vase containing flowers. Beside it sits a Queen Anne armchair. A golden mirror hangs on a wall. A massive Persian rug is in the middle of the room.

The study is to your northwest, the lounge is to your northeast, the ballroom is to your south, the library is to your southwest, and the dining room is to your southeast.

On the wooden side table is a dull silver candlestick.

>nw
Study

>e
Hall

>e
Lounge

>e
You can't go that way.

>w
Hall

>ne
Lounge

>w
Hall

>se
Dining room

>w
You can't go that way.

>w
You can't go that way.

>nw
Hall

>s
Ballroom

>se
Kitchen

>w
Ballroom

>sw
Conservatory

>n
Billiard Room

>e
Ballroom

>ne
Dining room

>sw
Ballroom

>nw
Billiard Room

>n
Library

>e
Hall

>w
Study

>e
Hall

* * *

>e
You can't go that way.

>e
You can't go that way.

* * *

>e
Hall

>s
Library

>s
You can't go that way.

>s
You can't go that way.

* * *

>s
Hall
The hall is a great central room in the mansion. You can see a wooden side table holding a bowl of fruit, flanked with chairs. On another table is a vase containing flowers. Beside it sits a Queen Anne armchair. A golden mirror hangs on a wall. A massive Persian rug is in the middle of the room.

The study is to your northwest, the lounge is to your northeast, the ballroom is to your south, the library is to your southwest, and the dining room is to your southeast.

On the wooden side table is a dull silver candlestick.

>s
Ballroom
The billiard room is to the northwest, the hall is to the north, the dining room is to the northeast, the conservatory is to the southwest, and the kitchen is to the southeast.

You can see a small pistol and a bronze candlestick here.

>s
You can't go that way.

* * *

>s
Ballroom
The billiard room is to the northwest, the hall is to the north, the dining room is to the northeast, the conservatory is to the southwest, and the kitchen is to the southeast.

You can see a small pistol and a bronze candlestick here.

>z
Time passes.

>z
Time passes.

Professor Plum arrives from Hall.

>z
Time passes.

>z
Time passes.

Professor Plum heads to Hall.

>z
Time passes.

You ran out of time.

    *** The End ***

In that game you scored 0 out of a possible 50, in 18 turns.

Would you like to RESTART, RESTORE a saved game, QUIT or UNDO the last command?

* * *

>s
Hall
The hall is a great central room in the mansion. You can see a wooden side table holding a bowl of fruit, flanked with chairs. On another table is a vase containing flowers. Beside it sits a Queen Anne armchair. A golden mirror hangs on a wall. A massive Persian rug is in the middle of the room.

The study is to your northwest, the lounge is to your northeast, the ballroom is to your south, the library is to your southwest, and the dining room is to your southeast.

On the wooden side table is a dull silver candlestick.

>sw
Library
The study is to your north, the hall is to your east, and the billiard room is to your south.

>go to game room
That noun did not make sense in this context.

>go to the game room
You walk to Billiard Room.

Billiard Room
The library is to the north, the ballroom is to the east, the conservatory is to the south.

* * *

>sw
Library
The study is to your north, the hall is to your east, and the billiard room is to your south.

>sw
You can't go that way.

>sw
You can't go that way.

* * *

>s
Hall
The hall is a great central room in the mansion. You can see a wooden side table holding a bowl of fruit, flanked with chairs. On another table is a vase containing flowers. Beside it sits a Queen Anne armchair. A golden mirror hangs on a wall. A massive Persian rug is in the middle of the room.

The study is to your northwest, the lounge is to your northeast, the ballroom is to your south, the library is to your southwest, and the dining room is to your southeast.

On the wooden side table is a dull silver candlestick.

>w
Study
In the center of the dimly lit study is a large wood desk with an ornate armchair. Another armchair sits against the wall. There are several paintings adorning the wall. Someone has lit a fire, which is still smoldering, in the fireplace. Books line shelves along the north and east walls. A rich green carpet, tattered in places, covers the floorboards.

The hall is to your east, and the library is to your south.

You can see a pocket knife here.

>d
Kitchen
The dining room is to the north, the ballroom is to the west.

You can see Ms Peacock here.

>d
Study
The hall is to your east, and the library is to your south.

You can see a pocketknife, Professor Plum and Colonel Mustard here.

>u
Kitchen
The dining room is to the north, the ballroom is to the west.

You can see a bronze candlestick here.

>e
You can't go that way.

* * *

>d
Kitchen
The dining room is to the north, the ballroom is to the west.

You can see Ms Peacock here.

>go to Study
You walk to Study.

Study
The hall is to your east, and the library is to your south.

You can see Professor Plum here.

* * *

>d
Kitchen
The dining room is to the north, the ballroom is to the west.

You can see Ms Peacock here.

>l around
The linoleum floors look clean.

>w
Ballroom
The billiard room is to the northwest, the hall is to the north, the dining room is to the northeast, the conservatory is to the southwest, and the kitchen is to the southeast.

You can see a lugwrench, a heavy gray handgun and Professor Plum here.

>l around
You found blood spots on the floor!

* * *

>d
Kitchen
The dining room is to the north, the ballroom is to the west.

You can see Ms Peacock here.

>u
You can't go that way.

>d
Study
The hall is to your east, and the library is to your south.

>u
You can't go that way.

>go to kitchen
You walk to Kitchen.

Kitchen
The dining room is to the north, the ballroom is to the west.

* * *

>w
Study
In the center of the dimly lit study is a large wood desk with an ornate armchair. Another armchair sits against the wall. There are several paintings adorning the wall. Someone has lit a fire, which is still smoldering, in the fireplace. Books line shelves along the north and east walls. A rich green carpet, tattered in places, covers the floorboards.

The hall is to your east, and the library is to your south.

You can see a pocket knife here.

>l at fireplace
You see nothing special about the fireplace.

* * *

>w
Study
In the center of the dimly lit study is a large wood desk with an ornate armchair. Another armchair sits against the wall. There are several paintings adorning the wall. Someone has lit a fire, which is still smoldering, in the fireplace. Books line shelves along the north and east walls. A rich green carpet, tattered in places, covers the floorboards.

The hall is to your east, and the library is to your south.

You can see a pocket knife here.

>l at mrs white
Mrs White has blood spots on their sleeve!

>s
Library
The study is to your north, the hall is to your east, and the billiard room is to your south.

>s
Billiard Room
The library is to the north, the ballroom is to the east, the conservatory is to the south.

>s
Conservatory
The ballroom is to the east. The billiard room is to the north.

>e
Ballroom
The billiard room is to the northwest, the hall is to the north, the dining room is to the northeast, the conservatory is to the southwest, and the kitchen is to the southeast.

You can see Ms Peacock here.

>e
Kitchen
The dining room is to the north, the ballroom is to the west.

You can see Miss Scarlet, Mr Green, Professor Plum and Colonel Mustard here.

>n
Dining room
The hall is to your northwest, the ballroom is to your southwest, the lounge is to your north, and the kitchen is to the south.

* * *

>s
Hall
The hall is a great central room in the mansion. You can see a wooden side table holding a bowl of fruit, flanked with chairs. On another table is a vase containing flowers. Beside it sits a Queen Anne armchair. A golden mirror hangs on a wall. A massive Persian rug is in the middle of the room.

The study is to your northwest, the lounge is to your northeast, the ballroom is to your south, the library is to your southwest, and the dining room is to your southeast.

On the wooden side table is a dull silver candlestick.

>z
Time passes.

>z
Time passes.

Professor Plum heads to Library.

>e
Lounge
The lounge is a comfortable place to sit and chat. The centerpiece is a long, comfortable sofa.

The hall is to your west, and the dining room is to your south.

You can see a lugwrench and Mr Green here.

Mr Green heads to Dining room.

>z
Time passes.

>s
Dining room
The hall is to your northwest, the ballroom is to your southwest, the lounge is to your north, and the kitchen is to the south.

You can see Ms Peacock here.

Ms Peacock heads to Hall.

>s
Kitchen
The dining room is to the north, the ballroom is to the west.

You can see a dull silver candlestick here.

>w
Ballroom
The billiard room is to the northwest, the hall is to the north, the dining room is to the northeast, the conservatory is to the southwest, and the kitchen is to the southeast.

You can see Mr Green, Miss Scarlet, a thin rope and Mrs White here.

Mrs White heads to Kitchen.

>z
Time passes.

>z
Time passes.

Miss Scarlet heads to Conservatory.

>z
Time passes.

>l at scarlet
You can't see any such thing.

I beg your pardon?

>z
Time passes.

>z
Time passes.

Mr Green heads to Kitchen.

>z
Time passes.

>se
Kitchen
The dining room is to the north, the ballroom is to the west.

You can see Colonel Mustard, Mr Green and a dull silver candlestick here.

>l at green
Mr Green is someone who looks weird.

>l at mustard
Colonel Mustard has blood spots on his sleeve!

Mr Green heads to Dining room.

>go to dining room
You walk to Dining room.

Dining room
The hall is to your northwest, the ballroom is to your southwest, the lounge is to your north, and the kitchen is to the south.

You can see Mr Green here.

>l around
It looks like the floors are a bit dusty.

>inbestigate
That's not a verb I recognise.

>inbestigate
That's not a verb I recognise.

>investigate
You don't see anything of note.

>hhhhhh
That's not a verb I recognise.

* * *

>z
Time passes.

Professor Plum heads to Library.

>w
Study
In the center of the dimly lit study is a large wood desk with an ornate armchair. Another armchair sits against the wall. There are several paintings adorning the wall. Someone has lit a fire, which is still smoldering, in the fireplace. Books line shelves along the north and east walls. A rich green carpet, tattered in places, covers the floorboards.

The hall is to your east, and the library is to your south.

You can see Miss Scarlet here.

>l at plum
Professor Plum is someone who looks weird.

>z
Time passes.

>z
Time passes.

Colonel Mustard arrives from Hall.

>l at mustard
Colonel Mustard is someone who looks weird.

Colonel Mustard heads to Hall.

>s
Library
The study is to your north, the hall is to your east, and the billiard room is to your south.

>w
You can't go that way.

>s
Billiard Room
The library is to the north, the ballroom is to the east, the conservatory is to the south.

You can see Ms Peacock and Miss Scarlet here.

>z
Time passes.

>l
Billiard Room
The library is to the north, the ballroom is to the east, the conservatory is to the south.

You can see Ms Peacock and Miss Scarlet here.

>z
Time passes.

>z
Time passes.

Colonel Mustard arrives from Conservatory.

>z
Time passes.

Colonel Mustard heads to Conservatory.

>z
Time passes.

* * *

>w
Study
In the center of the dimly lit study is a large wood desk with an ornate armchair. Another armchair sits against the wall. There are several paintings adorning the wall. Someone has lit a fire, which is still smoldering, in the fireplace. Books line shelves along the north and east walls. A rich green carpet, tattered in places, covers the floorboards.

The hall is to your east, and the library is to your south.

You can see Miss Scarlet here.

>s
Library
The study is to your north, the hall is to your east, and the billiard room is to your south.

>n
Study
In the center of the dimly lit study is a large wood desk with an ornate armchair. Another armchair sits against the wall. There are several paintings adorning the wall. Someone has lit a fire, which is still smoldering, in the fireplace. Books line shelves along the north and east walls. A rich green carpet, tattered in places, covers the floorboards.

The hall is to your east, and the library is to your south.

You can see Miss Scarlet here.

Miss Scarlet heads to Library.

>s
Library
The study is to your north, the hall is to your east, and the billiard room is to your south.

You can see Miss Scarlet here.

>e
Hall
The hall is a great central room in the mansion. You can see a wooden side table holding a bowl of fruit, flanked with chairs. On another table is a vase containing flowers. Beside it sits a Queen Anne armchair. A golden mirror hangs on a wall. A massive Persian rug is in the middle of the room.

The study is to your northwest, the lounge is to your northeast, the ballroom is to your south, the library is to your southwest, and the dining room is to your southeast.

You can see a pocket knife and Professor Plum here.

>z
Time passes.

Professor Plum heads to Entryway.

>z
Time passes.

Colonel Mustard arrives from Dining room.

>z
Time passes.

Miss Scarlet arrives from Library.

>e
Lounge
The lounge is a comfortable place to sit and chat. The centerpiece is a long, comfortable sofa.

The hall is to your west, and the dining room is to your south.

You can see a dull silver candlestick here.

>s
Dining room
The hall is to your northwest, the ballroom is to your southwest, the lounge is to your north, and the kitchen is to the south.

You can see Mrs White here.

>w
You can't go that way.

* * *

>z
Time passes.

Professor Plum heads to Library.

>z
Time passes.

Colonel Mustard heads to Entryway.

>z
Time passes.

Colonel Mustard arrives from Entryway.

>z
Time passes.

Colonel Mustard heads to Library.

>z
Time passes.

>z
Time passes.

Colonel Mustard arrives from Library.

>z
Time passes.

Colonel Mustard heads to Entryway.

* * *

>z
Time passes.

Colonel Mustard arrives from Entryway.

>z
Time passes.

Colonel Mustard heads to Study.

>z
Time passes.

>s
Ballroom
The billiard room is to the northwest, the hall is to the north, the dining room is to the northeast, the conservatory is to the southwest, and the kitchen is to the southeast.

>z
Time passes.

>s
You can't go that way.

>z
Time passes.

>e
Kitchen
The dining room is to the north, the ballroom is to the west.

You can see a small pistol and a pocket knife here.

>z
Time passes.

* * *

>s
You can't go that way.

>w
Ballroom
The billiard room is to the northwest, the hall is to the north, the dining room is to the northeast, the conservatory is to the southwest, and the kitchen is to the southeast.

Colonel Mustard arrives from Hall.

>w
Billiard Room
The library is to the north, the ballroom is to the east, the conservatory is to the south.

You can see a dull silver candlestick and Miss Scarlet here.

>z
Time passes.

>zl
That's not a verb I recognise.

>l
Billiard Room
The library is to the north, the ballroom is to the east, the conservatory is to the south.

You can see a dull silver candlestick and Miss Scarlet here.

>w
You can't go that way.

>n
Library
The study is to your north, the hall is to your east, and the billiard room is to your south.

Colonel Mustard arrives from Hall.

>l at mustard
Colonel Mustard is someone who looks weird.

Colonel Mustard heads to Hall.

* * *

Clue
An Interactive Fiction by the Andersons
Release 1 / Serial number 231122 / Inform 7 v10.1.2 / D

Entryway
Welcome to Clue! Your name is Detective Black. You are investigating a murder in the Mystery Mansion. You can move around the mansion, find suspects, the murder weapon (as well as some red herrings), and the scene of the crime. Once you've deduced the murder weapon, murderer, and room where the murder took place, you win! Just don't run out of time...

If you need help, type "help".

The hall is to your south.

>score
You have so far scored 0 out of a possible 50, in 1 turn.

>s
Hall
The hall is a great central room in the mansion. You can see a wooden side table holding a bowl of fruit, flanked with chairs. On another table is a vase containing flowers. Beside it sits a Queen Anne armchair. A golden mirror hangs on a wall. A massive Persian rug is in the middle of the room.

The study is to your northwest, the lounge is to your northeast, the ballroom is to your south, the library is to your southwest, and the dining room is to your southeast.

You can see a thin rope, Mrs White and Professor Plum here.

>score
You have so far scored 0 out of a possible 50, in 2 turns.

>s
Ballroom
The billiard room is to the northwest, the hall is to the north, the dining room is to the northeast, the conservatory is to the southwest, and the kitchen is to the southeast.